1111111111111111111
1C10000000C000001E1
1010011111111100101
1010000000000000101
1C100C0C0C0C0000101
10100C0C0C0C0000101
1C100C0C0C0C0000101
10100C0C0C0C0000101
10100C0C0P0C0000101
1010011111111100101
10000C0C0C0C0000001
1111111111111111111