111111
1E0011
111011
1CP011
111111