111111
1EC001
111101
1C00P1
101C11
1C1111
101111
1C1111
10CCC1
111111