1111111111111111111111111111111
1E000000000000000000CCC0000CC01
1010111111101111111111111111101
1010100000101010100000000101011
101010111C1010101111101010101C1
10101010CC1010101000001010101C1
10101010101010101010101010101C1
1010101010101010101C101C1010101
101000000000000000C000000000001
1010111111101111111111111111101
1010000000000000000000000000001
1010101010101010101010101010101
100000000000000P00000000000CCC1
1111111111111111111111111111111