11111
1P001
100C1
100E1
11111
10001
11111